tileset1.bmp
8
ciel
mur
mur
mur
mur
mur
mur
mur
15
13
0 0 0 0 0 0 0 0 0 0 0 0 0 0 0
0 0 0 0 0 0 0 0 0 0 0 0 0 0 0
0 0 0 0 0 0 0 0 0 0 0 0 0 0 0
0 0 0 0 0 0 0 0 0 0 0 0 0 0 0
1 0 0 0 0 0 0 0 0 1 1 1 1 1 0
0 0 0 0 0 0 0 0 0 0 0 0 0 0 0
0 0 0 0 0 0 0 0 0 0 0 0 0 0 0
0 0 0 0 0 0 0 0 0 0 0 0 0 0 0
0 0 3 4 0 0 0 2 2 2 2 0 0 2 2
0 0 5 6 0 0 0 0 0 0 0 0 0 0 0
0 0 5 6 0 0 0 0 0 0 0 0 0 0 0
0 0 5 6 0 0 0 0 0 0 0 0 0 0 0
7 7 7 7 7 7 7 7 7 7 7 7 7 7 7
